111111111111
1000C0000C01
100C00001001
10C00000P101
10C00100E001
111111111111